################
#.....NNNP..~O.#
#...1###########
#..#############
#..#############
#..#############
#....C...@.....#
#######~##.#####
#######2##S#####
##########S.####
################

souls: 9
1 -> S
2 -> N, P
P: over=PIT
S: over=PIT
decoys: 1, S
