################
#..............#
#...2..........#
#..............#
#..............#
#@C...........O#
#..............#
#..............#
#..............#
################

souls: 9
